I=primeiro
II=segundo
III=terceiro
IV=quarto
V=quinto
VI=sexto
VII=sétimo
VIII=oitavo
IX=nono
X=décimo
XI=décimo primeiro
XII=décimo segundo
XIII=décimo terceiro
XIV=décimo quarto
XV=décimo quinto
XVI=décimo sexto
XVII=décimo sétimo
XVIII=décimo oitavo
XIX=décimo nono
XX=vigésimo
XXI=vigésimo primeiro
XXII=vigésimo segundo
XXIII=vigésimo terceiro
XXIV=vigésimo quarto
XXV=vigésimo quinto
XXVI=vigésimo sexto
XXVII=vigésimo sétimo
XXVIII=vigésimo oitavo
XXIX=vigésimo nono
XXX=trigésimo
XL=quadragésimo
L=quinquagésimo
LX=sexagésimo
LXX=septuagésimo
LXXX=octogésimo
XC=nonagésimo
C=centésimo
